R    900 600 

 111111111111111111111111111111
10000000000000000000100000000011111
11111111111000000000000000000000001
10000000201000000000100000000000001
10000200001000000000100100000000001
1020000020100000000010000010111111
10000N00000000000020100001000000001
11111111111000000000100010000020001
10000200000000000000100100200000001
11111100000000010000101000002000001
     100000000000000110000000002001
      1111111111111111111111111111