R 600 400
NO ./texture/WALL46.xpm
SO ./texture/WALL2.xpm
WE ./texture/WALL0.xpm
EA ./texture/WALL4.xpm
S ./texture/greenlight.xpm
F 100,100,100
C 80,80,80


111111
100101111111
1020011100000001
1100N11111
111111