R 600 400
NO ./texture/WALL46.xpm
SO ./texture/WALL2.xpm
WE ./texture/WALL0.xpm
EA ./texture/WALL4.xpm
S ./texture/greenlight.xpm
F 100,100,100
C 80,80,80



        111111111111111111111111
        1000000000110000000000001
        1011000001110002002002001
        1001000000000W00000000001
111111111011000001110000000000001
100000000011000010110111111111111
11110111111111011100000010000001
1111011111111101110101000000111
11000000110101011100000010001
10002001000000001100000010001
 100000000200200001010010001
1100000111010101111101111000111
11110111 1110101 101111010001
11111111 1111111 111111111111